universe	n.宇宙      //verse旋转；uni统一,一起(the United States)//universal   adj.普遍的；全体的；共同的；university  n.普遍性
diverse	adj.不同的，多种多样的	//di=bi表示两个(bicycle自行车)
convert	v.(使)转变，转换	//vert=verse(旋转)，con(都)
land	n.陆地	//inland  adj.(在)内陆的  mainland  n.大陆   land in sth.使陷入(困境)
landscape	n.风景,景色	//land(陆地)sc(死看)ape(猿猴) 也是一道风景
broad	adj.宽阔的;概括的;一般的	//b(不)road(路),这路不好走，选择更宽的路//board  n.板子,甲板
wild	n.野生状态;偏远地区 adj.野生的;荒凉的	     //mild adj.温柔的(小猫喵(mild)的时候是温柔的)//wilderness   n.荒无人烟的地区
cape	n.披风	//c想成catch(抓住),ape(猿猴)，用披风抓住猿猴
coast	n.海岸;海滨	//想到coat(外套)  在海岸需要穿外套//coastal  adj.沿海的
island	n.岛	//谐音爱尔兰(就是岛)
isle	n.岛
peninsula	n.半岛
seaside	n.海边
shore	n.(海,湖泊)岸,滨	//像short,t变成e,e一般表示往外(如exit)，目之所及短，往远处沿伸
lawn	n.草坪	//law(法律)，n现象成门，lawer(律师)家门口有一大片草坪
ditch	n.沟,渠	//谐音(底池)就是沟
field	n.田,场地;界,领域	//fi(飞)e(鹅)l(像界限)d(地方)，飞鹅越过这个领域去这个地儿
paddy	n.稻田,水田	//趴地，趴水稻田干活
fertile	adj.肥沃的;富饶的;能生育的	//像fat(肥)，肥的人身体好能生育//fertility rate出生率//fertilizer  化肥   土地不肥沃就要用化肥
sheer	adj.完全的;陡峭的	//she + er 她是一个"完全的,十足的"人啊
slope	n.斜坡 v.倾斜	//类似于slow(慢慢的)"扑"，因为是斜坡,所以要小心
skyline	n.轮廓线	         //天空中的一条线就是轮廓
vacuum	n.真空;(用真空吸尘器)清洁	//vac(空的)   vacant(没人的)"厕所门口"   vacation假期
trash	n.废物;垃圾	//踹死这个废物

