substance	n.物质;根据;实质	//sub(下面)如"subway"地铁 stan(站)如"stand"，站在最下面的就是实质
atom	n.原子	
particle	n.颗粒;粒子	//part(部分) 把一个东西分成最小的//apartment  公寓//department 部门;学院  de表示往下或分开
gravity	n.重力;严肃;严重性	//grave(拼音gr官人a爱ve我到死) n.坟墓 adj.重大的 
air	n.空气	//in the air在传播中,流行//up in the air//悬而未决
sunset	n.日落;傍晚	//sun太阳  set当成"sit" 太阳坐下了//sunup日出
flow	n.流动v.流动	//fl飞流
fluid	n.液体;流体	//fld飞流了一地,液体才能流一地
stream	n.溪流;一连串v.流;飘动	//str字符串//mainstream  主流思想;主流群体
spray	n.浪花;水花;飞沫v.喷,洒	//s蛇p趴在ray光线里喷洒毒液
surge	n.浪涌,急剧上升v.涌;激增	//sur(上涨，上升)//谐音sur"射"喷射而出
fire	n.火;火灾v.射击,开枪,解雇	//fi(非)re(热)非常热(有火)
spark	n.烟花v.冒火花,引发		//park(公园) 在公园s"嘶嘶"放烟花
fuel	n.燃料;刺激因素v.给...提供燃料;加强;刺激	//飞呦，飞机飞呦需要加燃料
dense	adj.密集的	//一团绳子den死了//condense  压缩"所有变稠密"
melt	v.(使)熔化,融化	//蜜了他  融化了他
erode	v.侵蚀,风化,逐渐破坏;削弱,损害	//e + rode发音像road(路)，恶的路
echo	n.回声,共鸣,附和v.产生回响,附和	//e cho(异口同声)
source	n.源头,起源	//骚死，骚臭味要找源头//resourse  资源
mental	adj.精神上的,思想上的	//men  tal   人头上的就是精神上的
empty	adj.空的,无诚意的v.腾空,掏空	//email + pty葡萄牙，葡萄牙发我一封空邮件
sustainable	adj.合理利用的,可持续的	//只有sur向上,sub,sus等都是向下,tain=take拿着//sustain 支撑"从下面拿着"//一直撑着就是可持续的


